NO ./textures/redbrick.xpm
EA ./textures/wood.xpm
SO ./textures/greystone.xpm
WE ./textures/colorstone.xpm

F 220, 100, 0
C 225, 30, 0


111111
100101
101001
1100E1
111111