
NO ./textures/redbrick.xpm
EA ./textures/wood.xpm
SO ./textures/greystone.xpm
WE ./textures/colorstone.xpm

F 220, 100, 0
C 225, 30, 0


    11111 11111
    10000000111
1111100111111
100S0001
10000001
1000111
11111 1