
NO ./textures/redbrick.xpm
EA ./textures/wood.xpm
SO ./textures/greystone.xpm
WE ./textures/colorstone.xpm

C 220, 100, 0
F 225, 30, 0



     11111111111
    10000000111
1111100111111
100S0001
10000001
1000111
11101 1
 10001
 10001
 10001
 10001
 10001
 10001
 10001
 10001
 10001
 10001
 10001
 10001
 10001
 10001
 10001
 10001
 10001
 10001
 10001
 11001
 11111