



        11111111111111111111111111
        111111111111 1111111111111
        1111111111111011111111111
        11111111111100111111111111
11111111101100000110110110010100001111
1000000000110000011111111111111111
11110111111111011100001000111111111111
11110111111111011101110010001
11000000110101011100000010001
100000000N0000001100000010001
100000000001000001101010010001
1100000111010101111101111000111
11110111 11101011101111010001
1   1       1     1    1 111   
11111111111111111111111111111