
NO ./textures/redbrick.xpm
EA ./textures/wood.xpm
SO ./textures/greystone.xpm
WE ./textures/colorstone.xpm

F 220, 100, 0
C 225, 30, 0



11111
10001
100W1
10001
11111