
NO ./textures/redbrick.xpm
EA ./textures/wood.xpm
SO ./textures/greystone.xpm
WE ./textures/colorstone.xpm

F 220, 100, 0
C 225, 30, 0

11111111111111111
10000000000000001
10000000000000001
101E1000000000001
10000000000000001
10000000000000001
10000000W00000001
10000000000000001
10000000000000001
10000000000000001
10000000000000001
10000000000000001
11111111111111111