NO ./textures/redbrick.xpm
EA ./textures/wood.xpm
SO ./textures/greystone.xpm
WE ./textures/colorstone.xpm

F 220, 100, 0
C 225, 30, 0


111111111111111111111111111111
100000000000100010000000000001
100000000000000000000000000001
110000000000000000000000000011
10000000000000S000000000000001
110000000000000000000000000011
100000000000000000000000000001
100000000000001000100000000001
100000001111000000111110000001
111111111111111111111111111111