

NO ./textures/redbrick.xpm
SO ./textures/greystone.xpm
WE ./textures/colorstone.xpm
EA ./textures/wood.xpm


F 0, 0, 0
C 0, 0, 0


11111111111111111
10000000000000001
10000000000000011110
10111000000000001110
10000000000000011110
11100000000000001
10010000000000001
11100000000000001
10000000000000011
10000000000000001
1000000000000S011
10000000000000001
11111111111111111